{
	"maps": {
		"LVL1": {
			"map":
				[
					["---", "---", "---", "---", "---", "---", "---", "---", "---", "---", "---", "---", "---", "---", "---", "---", "---", "---", "---", "---", "---", "---", "---", "---", "---", "---", "---", "---", "---", "---"],
					["---", "---", "---", "---", "---", "---", "---", "---", "---", "---", "---", "---", "---", "---", "---", "---", "---", "---", "---", "---", "---", "---", "---", "---", "---", "---", "---", "---", "---", "---"],
					["---", "---", "---", "---", "---", "---", "---", "---", "---", "---", "---", "---", "---", "---", "---", "---", "---", "---", "---", "---", "---", "---", "---", "---", "---", "---", "---", "---", "---", "---"],
					["---", "---", "---", "---", "---", "---", "---", "---", "---", "---", "---", "---", "---", "---", "---", "---", "---", "---", "---", "---", "---", "---", "---", "---", "---", "---", "---", "---", "---", "---"],
					["---", "---", "---", "---", "---", "---", "---", "---", "---", "---", "---", "---", "---", "---", "---", "---", "---", "---", "---", "---", "---", "---", "---", "---", "---", "---", "---", "---", "---", "---"],
					["---", "---", "---", "---", "---", "---", "---", "---", "---", "---", "---", "---", "---", "---", "---", "---", "---", "---", "---", "---", "---", "---", "---", "---", "---", "---", "---", "---", "---", "---"],
					["---", "---", "---", "---", "---", "---", "---", "---", "---", "---", "---", "---", "---", "---", "---", "---", "---", "---", "---", "---", "---", "---", "---", "---", "---", "---", "---", "---", "---", "---"],
					["---", "---", "---", "---", "---", "---", "---", "---", "---", "---", "---", "---", "---", "---", "---", "---", "---", "---", "---", "---", "---", "---", "---", "---", "---", "---", "---", "---", "---", "---"],
					["---", "---", "---", "---", "---", "---", "---", "---", "---", "---", "---", "---", "---", "---", "---", "---", "---", "---", "---", "---", "---", "---", "---", "---", "---", "---", "---", "---", "---", "---"],
					["---", "---", "---", "---", "---", "---", "---", "---", "---", "---", "---", "---", "---", "---", "---", "---", "---", "---", "---", "---", "---", "---", "---", "---", "---", "---", "---", "---", "---", "---"],
					["---", "---", "---", "---", "---", "---", "---", "---", "---", "---", "---", "---", "---", "---", "---", "---", "---", "---", "---", "---", "---", "---", "---", "---", "---", "---", "---", "---", "---", "---"],
					["---", "---", "---", "---", "---", "---", "---", "---", "---", "---", "---", "---", "---", "---", "---", "---", "---", "---", "---", "---", "---", "---", "---", "---", "---", "---", "---", "---", "---", "---"],
					["---", "---", "---", "---", "---", "---", "---", "---", "---", "---", "---", "---", "---", "---", "---", "---", "---", "---", "---", "---", "---", "---", "---", "---", "---", "---", "---", "---", "---", "---"],
					["---", "---", "---", "---", "---", "---", "---", "---", "---", "---", "---", "075", "076", "076", "076", "077", "---", "---", "---", "---", "---", "---", "---", "---", "---", "---", "---", "---", "---", "---"],
					["---", "---", "---", "---", "---", "---", "---", "---", "---", "---", "---", "---", "098", "099", "101", "---", "---", "---", "---", "---", "---", "---", "---", "---", "---", "---", "---", "---", "---", "---"],
					["---", "---", "---", "---", "032", "001", "001", "001", "001", "033", "---", "---", "098", "099", "101", "---", "---", "---", "---", "---", "---", "---", "---", "---", "---", "---", "---", "---", "---", "---"],
					["000", "001", "001", "001", "042", "024", "024", "024", "024", "043", "001", "001", "001", "001", "001", "001", "001", "001", "001", "001", "001", "001", "001", "001", "001", "001", "001", "001", "001", "002"],
					["023", "024", "024", "024", "024", "024", "024", "024", "024", "024", "024", "024", "024", "024", "024", "024", "024", "024", "024", "024", "024", "024", "024", "024", "024", "024", "024", "024", "024", "025"],
					["023", "024", "024", "024", "024", "024", "024", "024", "024", "024", "024", "024", "024", "024", "024", "024", "024", "024", "024", "024", "024", "024", "024", "024", "024", "024", "024", "024", "024", "025"],
					["023", "024", "024", "024", "024", "024", "024", "024", "024", "024", "024", "024", "024", "024", "024", "024", "024", "024", "024", "024", "024", "024", "024", "024", "024", "024", "024", "024", "024", "025"]
				]
		}
	}
}
